NO ./textures/Bookshelf_64.png
SO ./textures/chairman_128.png
WE ./textures/SPace_64.png
EA ./textures/Grass_with_Flowers_64.png

F 220,200,200
C 225,30,0




        1111111111111111111111111
        1000000101110000000000001
        1011000101110000000000001
        1001000000000000000000001
111111111011000001110000000000001
100000000011000001110111111111111
11110111111111011100000010001
11110111111111011101010010001
11000000110101011100000010001
10000000S00000001100000010001
10000000000000001101010010001
11000001010101010111111100111
1111111111111111111111111111
11110111111010111011  11010001
11100000000000000000000000001
1111111111111111111111111111
