NO ./textures/NO.png
SO ./textures/SO.png
WE ./textures/WE.png
EA ./textures/EA.png

F 220,100,0
C 225,30,0





        1111111111111111111111111
        10000001S1110000000000001
        1011000101110000000000001
        1001000000000000000000001
111111111011000001110000000000001
100000000011000001110111111111111
11110111111111011100000010001
11110111111111011101010010001
11000000110101011100000010001
10000000000000001100000010001
10000000000000001101010010001
110000010101010101111  1100111
1111111111111111111100111111
11110111111010111011  11010001
11100000000000000000000000001
11111111111111111111100111111