NO ./textures/Bookshelf_64.png
SO ./textures/chairman_128.png
WE ./textures/SPace_64.png
EA ./textures/Grass_with_Flowers_64.png

F 220,200,200
C 225,30,0




1111
1N